00000000000000000000000000000000000000000000000000000000000000000000000000000
00000000000000000000000000000000000000000000000000000000000000000000000000000
00000000000000000000000000000000000000000000000000000000000000000000000000000
00000000000000000000000000000000000000000000000000000000000222000000000000000
00000000000000000000000000000000000000000000000000000022000000000002222000000
00000000000000000000000000000000000000000000000000022211000000000001111000000
22000000000000000002200000022000022222222222222000001111200000000000111000000
11222222222222222221100002211200001111111111110000000111100000000000011000000
11111111111111111111100001111100000111111111100000000011100000000000000000000
11111111111111111111100000110000000011111111000000000001100000000000000000000
11111111111111111111100000100000000011111110000000000000100000000000000000000
11111111111111111111100000100000000011111100000000000000000000000000000000000
11111111111111111111000000000000000111110000000000000000000000000000000000000